NO                      ./textures/vinil.png

C                    2,2,200

SO ./textures/vinil.png

WE     ./textures/vinil.png

EA                   ./textures/vinil.png

F           220,100,0


        1111111111111111111111111
        1000000000110000000000001
        101100M001110000N0A000001
        1001000000000000000000001
111111111011000001110000000000001
100000000011000001110111110111111
11110111111111011100000010001
11110111111111011101000000001
11000000110101011100000010001
10000000000000001100000010001
1000000000T000001101010010001
1100000111010101111101111000111
11110111 1110101 1011110100D1
11111111 1111111 111111111111