NO ./textures/beton.png
SO ./textures/beton.png
WE ./textures/beton.png
EA ./textures/sky.png


C 0,0,102
F 0,51,25


11111111111111111111111
10000000000000N00000001
10000000000000000000001
10000000000000000000001
11111111111111111111111
10000000000000000000001
11110111111111011101010010001
11000000110101011100000010001
10000000000000001100000000001
10000000000000001101010010001
110000011101010111110111100111
11110111 1110101 101111010001
11111111 1111111 11111111111